G G B G B G B G B G G B
B B B G G B G G S G G G
B G G G G B G G G G S G
B G G G B B G B G G B S
B G G G G B G G G G G B
B G G G B B B G G G G S
S S G G G G G G S S G S
G G G B B B B B B G G G
B G G S S S G G B B B G