G G B G B G B G B G G G
B B B G G B G G G G G G
B G G G G G G G G G G G
B G G G B B G B G G B G
G B G G G G G G G G G G
B G G G B G B G G B G G
G G G G G G G G G G G G
G G G B B G B G B G G G
B G G G G G G G G B B G