G G B G B G B G B G G G G G B G B G B G B G G G
B G G G G G G G G B B G G G B G B G B G B G G G
G G B G B G B G B G G G G G B G B G B G B G G G
SW SW SW SW SW SW SW SW SW SW SW SW SW SW SW SW SW SW SW SW SW SW SW SW
SW SW SW SW SW SW SW SW SW SW SW SW SW SW SW SW SW SW SW SW SW SW SW SW
ST ST ST ST ST ST ST ST ST ST ST ST ST ST ST ST ST ST ST ST ST ST ST ST
ST ST ST ST ST ST ST ST ST ST ST ST ST ST ST ST ST ST ST ST ST ST ST ST
ST ST ST ST ST ST ST ST ST ST ST ST ST ST ST ST ST ST ST ST ST ST ST ST
ST ST ST ST ST ST ST ST ST ST ST ST ST ST ST ST ST ST ST ST ST ST ST ST
ST ST ST ST ST ST ST ST ST ST ST ST ST ST ST ST ST ST ST ST ST ST ST ST
ST ST ST ST ST ST ST ST ST ST ST ST ST ST ST ST ST ST ST ST ST ST ST ST
ST ST ST ST ST ST ST ST ST ST ST ST ST ST ST ST ST ST ST ST ST ST ST ST
ST ST ST ST ST ST ST ST ST ST ST ST ST ST ST ST ST ST ST ST ST ST ST ST
SW SW SW SW SW SW SW SW ST ST ST ST ST ST ST ST SW SW SW SW SW SW SW SW
SW SW SW SW SW SW SW SW ST ST ST ST ST ST ST ST SW SW SW SW SW SW SW SW
B G G G G G SW SW ST ST ST ST ST ST ST ST SW SW B G B G G G
G G B G B G SW SW ST ST ST ST ST ST ST ST SW SW B G B G G G
B G G G G G SW SW ST ST ST ST ST ST ST ST SW SW B G B G G G