o G B G B G B G B G G B
0 B B G G B G G S G G G
0 G G G G B G G G G S G
o G G G B B G B G G B S
= = = = = = = G G G G B
o G G G B B B G G G G S
o S G G G G G G S S G S
o G G B B B B B B G G G
0 G G S S S G G B B B G