GR GR BU GR BU GR BU GR BU GR GR GR GR GR BU GR BU GR BU GR BU GR GR GR
BU GR BU GR GR GR GR GR GR BU BU GR GR GR BU GR BU GR BU GR BU GR GR GR
PF PF PF PF PF PF PF PF PF PF PF PF PF PF PF PF PF PF PF PF PF PF PF PF
SW SW SW SW SW SW SW SW SW SW SW SW SW SW SW SW SW SW SW SW SW SW SW SW
SW SW SW SW SW SW SW SW SW SW SW SW SW SW SW SW SW SW SW SW SW SW SW SW
ST ST ST ST ST ST ST ST ST ST ST ST ST ST ST ST ST ST ST ST ST ST ST ST
ST ST ST ST ST ST ST ST ST ST ST ST ST ST ST ST ST ST ST ST ST ST ST ST
ST ST ST ST ST ST ST ST ST ST ST ST ST ST ST ST ST ST ST ST ST ST ST ST
ST ST ST ST ST ST ST ST ST ST ST ST ST ST ST ST ST ST ST ST ST ST ST ST
ST ST ST ST ST ST ST ST ST ST ST ST ST ST ST ST ST ST ST ST ST ST ST ST
ST ST ST ST ST ST ST ST ST ST ST ST ST ST ST ST ST ST ST ST ST ST ST ST
ST ST ST ST ST ST ST ST ST ST ST ST ST ST ST ST ST ST ST ST ST ST ST ST
ST ST ST ST ST ST ST ST ST ST ST ST ST ST ST ST ST ST ST ST ST ST ST ST
SW SW SW SW SW SW SW SW ST ST ST ST ST ST ST ST SW SW SW SW SW SW SW SW
SW SW SW SW SW SW SW SW ST ST ST ST ST ST ST ST SW SW SW SW SW SW SW SW
BU GR GR GR GR GR SW SW ST ST ST ST ST ST ST ST SW SW BU GR BU GR GR GR
GR GR BU GR BU GR SW SW ST ST ST ST ST ST ST ST SW SW BU GR BU GR GR GR
BU GR GR GR GR GR SW SW ST ST ST ST ST ST ST ST SW SW BU GR BU GR GR GR