GR GR BU GR BU GR BU GR BU GR GR GR GR GR BU GR BU GR BU GR BU GR GR GR
BU GR BU GR GR GR GR GR GR BU BU GR GR GR BU GR BU GR BU GR BU GR GR GR
GR BU GR GR GR BU GR GR BU GR GR GR BU GR GR BU GR GR GR BU GR GR BU GR
SW SW SW SW SW SW SW SW SW SW SW SW SW SW SW SW SW SW SW SW SW SW SW SW
SW SW SW SW SW SW SW SW SW SW SW SW SW SW SW SW SW SW SW SW SW SW SW SW
ST ST ST ST ST ST ST ST ST ST ST ST ST ST ST ST ST ST ST ST ST ST ST ST
ST ST ST ST ST ST ST ST ST ST ST ST ST ST ST ST ST ST ST ST ST ST ST ST
ST ST ST ST ST ST ST ST ST ST ST ST ST ST ST ST ST ST ST ST ST ST ST ST
Y2 Y2 Y2 Y2 Y2 Y2 Y2 Y2 Y2 Y2 Y2 Y2 Y2 Y2 Y2 Y2 Y2 Y2 Y2 Y2 Y2 Y2 Y2 Y2
Y1 Y1 Y1 Y1 Y1 Y1 Y1 Y1 Y1 Y1 Y1 Y1 Y1 Y1 Y1 Y1 Y1 Y1 Y1 Y1 Y1 Y1 Y1 Y1
ST ST ST ST ST ST ST ST ST ST ST ST ST ST ST ST ST ST ST ST ST ST ST ST
ST ST ST ST ST ST ST ST ST ST ST ST ST ST ST ST ST ST ST ST ST ST ST ST
ST ST ST ST ST ST ST ST ST ST ST ST ST ST ST ST ST ST ST ST ST ST ST ST
SW SW SW SW SW SW SW SW SW SW SW SW SW SW SW SW SW SW SW SW SW SW SW SW
SW SW SW SW SW SW SW SW SW SW SW SW SW SW SW SW SW SW SW SW SW SW SW SW
GR BU GR GR GR BU GR GR BU GR GR GR BU GR GR BU GR GR GR BU GR GR BU GR
GR GR BU GR BU GR GR GR BU GR BU GR BU GR BU GR BU GR BU GR BU GR GR GR
BU GR BU GR GR GR GR GR GR BU BU GR GR GR BU GR BU GR BU GR BU GR GR GR