GR GR BU GR BU GR BU GR BU GR GR GR GR GR BU GR BU GR BU GR BU GR GR GR
BU GR BU GR GR GR GR GR GR BU BU GR GR GR BU GR BU GR BU GR BU GR GR GR
GR BU GR PF PF PF PF GR BU GR PF PF PF PF GR BU GR PF PF PF PF GR BU GR
SW SW SW SW SW SW SW SW SW SW SW SW SW SW SW SW SW SW SW SW SW SW SW SW
SW SW SW SW SW SW SW SW SW SW SW SW SW SW SW SW SW SW SW SW SW SW SW SW
ST ST ST ST ST ST ST ST ST ST ST ST ST ST ST ST ST ST ST ST ST ST ST ST
ST ST ST ST ST ST ST ST ST ST ST ST ST ST ST ST ST ST ST ST ST ST ST ST
ST ST ST ST ST ST ST ST ST ST ST ST ST ST ST ST ST ST ST ST ST ST ST ST
ST ST ST ST ST ST ST ST ST ST ST ST ST ST ST ST ST ST ST ST ST ST ST ST
ST ST ST ST ST ST ST ST ST ST ST ST ST ST ST ST ST ST ST ST ST ST ST ST
ST ST ST ST ST ST ST ST ST ST ST ST ST ST ST ST ST ST ST ST ST ST ST ST
ST ST ST ST ST ST ST ST ST ST ST ST ST ST ST ST ST ST ST ST ST ST ST ST
ST ST ST ST ST ST ST ST ST ST ST ST ST ST ST ST ST ST ST ST ST ST ST ST
SW SW SW SW SW SW SW SW SW SW SW SW SW SW SW SW SW SW SW SW SW SW SW SW
SW SW SW SW SW SW SW SW SW SW SW SW SW SW SW SW SW SW SW SW SW SW SW SW
GR BU GR IF IF IF IF GR BU GR IF IF IF IF GR BU GR IF IF IF IF GR BU GR
GR GR BU GR BU GR GR GR BU GR BU GR BU GR BU GR BU GR BU GR BU GR GR GR
BU GR BU GR GR GR GR GR GR BU BU GR GR GR BU GR BU GR BU GR BU GR GR GR